00 00 00 00 00 00 00 00 00 00 00 00 00 00 00 00 00 00 00 00
00 00 00 00 00 00 00 00 00 00 00 00 00 00 00 00 00 00 00 00
00 00 00 12 12 12 12 00 00 00 00 00 12 12 12 12 00 00 00 00
00 00 00 00 00 00 00 00 00 00 00 00 00 00 00 00 00 00 00 00
00 00 00 00 00 00 00 00 00 00 00 00 00 00 00 00 00 00 00 00
00 00 00 00 00 00 00 00 00 00 00 00 00 00 00 00 00 00 00 00
08 10 09 00 00 00 00 00 00 00 00 00 00 00 00 00 00 08 10 09
00 07 00 00 00 00 00 00 00 00 00 00 00 00 00 00 00 00 07 00
00 07 00 00 00 00 00 00 00 00 00 00 00 00 00 00 00 00 07 00
00 07 12 12 00 00 00 12 12 12 12 12 00 00 00 12 12 00 07 00
00 07 00 00 00 00 00 00 00 00 00 00 00 00 00 00 00 00 07 00
00 07 00 00 00 00 00 00 00 00 00 00 00 00 00 00 00 00 07 00
00 07 00 00 00 00 00 00 12 12 12 00 00 00 00 00 00 00 07 00
00 07 00 00 00 00 00 00 12 12 12 00 00 00 00 00 00 00 07 00
02 02 02 02 02 02 02 02 02 02 02 02 02 02 02 02 02 02 02 02

1.(150,100,200,50)
2.(600,100,200,50)

3.(400,250,150,50)
4.(0,300,150,50)
5.(900,300,150,50)

7.(100,550,100,50)
8.(800,550,100,50)

9.(350,550,250,50)

10.(400,700,150,100)



 
